*XX******X
**XXX*XX*X
X*****XX*X
XX*XXXXX*X
X********X
X*XX*XXXXX
X*XX*XXXXX
X*XXXXXXXX
X*********
XXXXXXXXX*